NO textures/pipes.xpm

WE textures/console.xpm
SO textures/supports_space.xpm
EA textures/wall_space.xpm
F 0,0,0
C 0,0,0



11111111111111111111111111111111111111111111111111111111111111111111111111111111111111111111
1  10010010010010010010010010000000000000000000000000000000000000000000000000000000000000001
1  10000000100000000000000100011101111111111111111111011111111111111111111111111111111111101
1111000000000000001000000000001 101                 101                                  101
100000010010010010010N100100111 101                 101                                  101
1001010010010010010010010010001  1                  101                                  101
10000100000000111110100100110011111111111111111111111011111111111111111111111111111111111101
1111111111111111111111111000111            1111100000000000000000000000000000000000000000001
                      1000101111111111111111111101111111111111111111111111111111111111111111
                      1111100000000000000000000001
                          111111111111111111111111
                          111111
                          100011
                          111111
