11111111111111111111111111111111111111111111111111
10000000000000000000000000000000000000000000000001
10000000000000000000000000000000000000000000000001
10000000000000000000000000000000000000000000000001
10000000000000000000000000000000000000000000000001
10000000000000000000000000000000000000000000000001
10000000000000000000000000000000000000000000000001
10000000000000000000000000000000000000000000000001
10000000444444400000000000000000000000000000000001
10000000400000400000000000000000000000000000000001
10000000400000400000000000000000000000000000000001
10000000400000400000000000000000000000000000000001
10000000444044400000000000000000000000000000000001
10000000000000000300000000000000000000000000000001
10000000000000000300000000000000000000000000000001
10000000000000000300000000000000000000000000000001
10000000000000000300000000000000000000000000000001
10000000000000000300000000000003000000000000000001
10000000000000000300000000000030000000000000000001
10000000000000000300000000000300000000000000000001
10000000000000000300000000003000000000000000000001
10000000000000000300000000030000000000000000000001
10000000000000000333333303330000000000000000000001
10000000000000000000000000000000000000000000000001
10000000000000000000000000000000000000000000000001
10000001000000000000000000200000000000000000000001
10000001000000000000000002220000000000000000000001
10000002000000000000000022002200000000000000000001
10000002000000000000000220000022000000000000000001
10000003000000000000022222002222200000000000000001
10000003000000000000000000000000000000000000000001
10000004000000000000000000000000000000000000000001
10000004000000000000000000000000000000000000000001
10000000000000000000000000000000000000000000000001
10000000000000000000000000000000000000000000000001
10000000000000000000000110000000000000000000000001
10000000000000000000001101100000000000000000000001
10000000000000000000001000010000000000000000000001
10000000000000000000010000001000000000000000000001
10000000000000000000010000001000000000000000000001
10000000000000000000001000010000000000000000000001
10000000000000000000000100100000000000000000000001
10000000000000000000000011000000000000000000000001
10000000000000000000000000000000000000000000000001
10000000000000000000000000000000000000000000000001
1000000N000000000000000000000000000000000000000001
10000000000000000000000000000000000000000000000001
10000000000000000000000000000000000000000000000001
10000000000000000000000000000000000000000000000001
11111111111111111111111111111111111111111111111111
